################################################################
###.############################################################
##.................................#############################
##.................................#############################
##..############################################################
##..############################################################
##.................................#############################
##.................................#############################
##..############################################################
##..############################################################
##.................................#############################
##.................................#############################
##..############################################################
##..############################################################
##..............................................................
##..............................................................
##..############################################..##############
##..############################################..##############
##..############################################..##############
##..############################################..##############
##..############################################..##############
##..############################################..##############
##..############################################..##############
##..############################################..##############
##..############################################..##############
##..############################################..##############
##..############################################..##############
##..############################################..##############
##..############################################..##############
##..############################################..##############
##..############################################################
##..############################################################
##..############################################################
##..############################################################
##..############################################################
##..############################################################
##..############################################################
##..############################################################
##..############################################################
##..############################################################
##..############################################################
##..############################################################