##########..########
##########..########
##########..########
##########..########
#####.......########
#####.....##########
#####..#############
#####..#############
#####..#############
#####..#############
#####..#############