################################################################
################################################################
################################################################
################################################################
################################################################
##.................................#############################
##.................................#############################
##.................................#############################
##...###########################################################
##...###########################################################
##...###########################################################
##...###########################################################
##...###########################################################
##..............................................................
##..............................................................
##..............................................................
##...##########################################...##############
##...##########################################...##############
##...##########################################...##############
##...##########################################...##############
##...##########################################...##############
##...##########################################...##############
##...##########################################...##############
##...##########################################...##############
##...##########################################...##############
##...##########################################...##############
##...##########################################...##############
##...##########################################...##############
##...##########################################...##############
##...##########################################...##############
##...##########################################...##############
##...##########################################...##############
##...##########################################...##############
##...##########################################...##############
##...##########################################...##############
##...##########################################...##############
##...##########################################...##############
##...##########################################...##############
##...##########################################...##############
##...##########################################...##############
##...##########################################...##############
##...##########################################...##############